40
32
20 20 20 20 20 20 20 20 20 20 20 20 20 20 20 20 20 20 20 20 20 20 20 20 20 20 20 20 20 20 20 20 20 20 20 20 20 20 20 20
20 1 1 1 1 21 1 1 1 1 1 1 1 1 1 1 1 1 1 1 1 1 1 1 1 1 1 1 1 1 1 20 20 1 1 1 1 1 1 20
20 1 1 20 20 20 20 1 1 1 1 1 20 1 1 1 1 1 1 21 1 1 1 1 1 1 1 21 1 1 1 20 20 1 1 1 1 1 1 20
20 1 1 1 1 21 1 1 1 1 1 20 20 1 1 1 1 1 1 1 1 1 1 1 1 20 20 1 1 1 1 20 20 20 20 20 20 1 1 20
20 1 1 1 1 1 1 1 1 1 1 20 20 20 20 20 20 20 20 20 20 20 20 20 20 20 20 1 1 1 1 20 20 1 1 1 1 1 1 20
20 1 1 1 20 20 20 20 20 20 20 20 20 20 1 1 1 1 1 1 1 1 1 1 1 1 1 1 1 1 1 20 1 1 1 20 20 1 1 20
20 1 1 1 1 1 1 1 1 1 1 1 1 1 1 1 1 1 1 1 1 1 1 1 1 20 20 1 1 1 1 1 1 1 1 20 20 1 1 20
20 1 1 1 20 20 20 20 1 20 1 1 1 1 1 20 20 20 20 20 20 20 20 20 20 20 20 20 20 1 1 1 21 1 1 1 1 1 1 20
20 1 1 1 1 1 20 20 1 20 1 1 1 1 1 20 1 1 1 1 1 1 20 20 1 1 1 1 1 1 21 1 1 1 1 1 1 1 1 20
20 1 1 1 1 1 1 20 1 20 1 1 1 1 1 20 1 1 1 1 1 1 20 20 1 1 1 20 20 1 1 1 1 20 20 20 20 1 21 20
20 20 1 1 1 1 1 20 1 20 20 20 20 20 20 20 20 20 20 1 21 1 20 20 1 1 1 20 20 1 1 1 1 20 20 1 1 1 1 20
20 20 20 1 1 1 1 1 1 1 1 1 1 1 1 1 1 1 20 1 1 1 20 20 1 1 1 1 1 1 1 1 20 20 20 1 1 1 1 20
20 20 20 20 1 1 1 1 20 1 1 1 1 1 1 1 1 1 20 20 1 1 20 20 20 20 21 1 1 20 20 20 20 20 1 1 1 1 21 20
20 1 1 1 21 1 1 1 20 20 20 1 1 1 20 20 1 1 20 20 1 1 1 20 1 1 1 1 1 1 1 1 1 1 1 1 1 1 1 20
20 1 1 1 1 1 1 1 1 20 20 20 20 20 20 20 1 1 20 20 1 1 1 20 1 1 1 1 21 1 1 1 20 20 20 20 1 1 1 20
20 21 20 1 20 1 21 1 1 1 20 20 1 1 1 1 1 1 20 1 1 1 1 20 1 21 1 1 1 1 1 1 20 20 20 20 1 1 1 20
20 1 20 1 20 1 1 21 1 1 1 20 1 21 1 1 20 20 20 1 1 21 1 1 1 1 20 20 20 20 1 1 1 1 1 1 1 1 1 20
20 1 20 1 20 1 1 1 1 20 1 1 1 1 1 1 1 20 20 1 1 1 1 1 1 1 20 20 20 20 1 1 21 1 1 20 20 20 20 20
20 1 20 1 20 20 1 1 20 20 1 21 1 1 1 21 1 20 20 20 20 20 20 1 1 1 20 20 1 1 1 1 1 1 1 1 1 1 1 20
20 1 20 20 20 20 1 1 20 20 1 21 1 1 1 1 1 20 20 20 20 20 20 20 21 1 20 20 1 1 1 1 1 1 1 1 1 1 1 20
20 1 1 1 1 1 1 1 1 1 2121 1 1 1 1 1 1 1 1 1 1 1 1 20 1 1 20 20 1 1 1 20 20 20 20 20 1 1 1 20
20 20 20 1 1 1 20 20 1 1 1 20 20 1 1 1 20 1 1 1 1 1 20 20 1 1 20 20 1 1 1 1 20 20 1 1 1 1 1 20
20 1 1 1 1 20 20 20 1 1 1 20 20 20 1 1 20 20 20 20 20 20 20 1 1 1 1 1 1 1 1 1 20 20 1 21 1 1 1 20
20 1 1 1 20 20 20 1 1 20 1 20 20 1 1 1 1 1 1 1 1 1 1 1 1 1 1 20 1 1 1 1 20 20 1 1 1 1 1 20
20 20 1 21 1 1 1 1 1 20 1 1 1 1 1 1 1 1 1 1 1 1 1 1 1 1 20 1 1 1 1 1 1 20 1 1 20 20 20 20
20 20 1 1 1 1 1 21 1 1 20 20 20 20 20 20 20 20 1 1 1 1 1 1 1 20 1 1 1 1 1 1 20 20 1 1 1 1 1 20
20 20 1 1 1 1 1 21 1 1 20 20 20 20 20 20 20 20 1 1 1 20 20 20 20 20 1 1 1 1 21 1 1 1 20 1 1 1 1 20
20 20 20 20 20 1 1 1 1 1 20 20 1 1 1 1 20 20 1 1 20 20 20 20 20 20 1 1 1 1 1 21 1 1 20 20 20 20 1 20
20 1 1 20 20 1 1 20 20 20 20 20 1 21 1 1 20 20 1 1 20 20 1 1 20 20 1 1 1 1 1 1 1 1 1 1 20 20 1 20
20 1 1 1 1 1 1 21 1 1 20 20 1 1 1 1 1 1 1 21 1 1 1 1 20 20 1 1 1 1 1 1 1 1 1 1 20 20 1 20 
20 1 1 1 21 1 1 1 1 1 20 20 1 1 1 1 21 1 1 1 1 1 1 20 20 20 20 20 1 1 1 1 1 1 1 1 20 20 1 20
20 20 20 20 20 20 20 20 20 20 20 20 20 20 20 20 20 20 20 20 20 20 20 20 20 20 20 20 20 20 20 20 20 20 20 20 20 20 20 20